amazon	amzn
amazon	amznjp
amazon	amznde
eastbay	etby
6pm	sxpm
zappos	zpos
finishline	finl
jomashop	jmsh
jacobtime	jacb
ashford	ainc
bluefly	bfly
ralphlauren	rllr
adidas	adds
ae	aeae
asos	ascl
7forallmankind	samk
watchco	waco
newegg	negg
onlineshoes	olsh
victoriassecret	vctrs
misssixty 	msst
levi	levis
juicycouture	jcct
shoebacca	shbc
disesl	disesl
nordstrom	ndst
ebags	ebag
titleboxing	ttbx
noblecollection	nbcl
backcountry	bkcy
neimanmarcus	nmmc
bottegaveneta	btvt
burberry 	brby
campmor	camp
clarksusa	clarks
columbia 	colm
dicks	dks
drmartens 	drmt
ecco	ecco
eyesave	eysv
pickyourshoes	pkys
shoebuy	shby
bloomingdales	blda
jimmyjazz	jmjz
macys	mcys
neimanmarcus	nmmc
buyeyeglasses	byyg
forever21	fe21
fossil	fosl
hockeymonkey	hkmk
hushpuppies	hspy
minnetonka	mntk
nike	nike
nike_hk 	nikehk
ninewest 	ninew
nooka	noka
orlakiely	orlk
overstock	ostk
saksfifthavenue	sfan
skechers	skxr
steve madden	shoo
sunglasshut	slsh
thenorthface	thnf
thewatchery	twch
timberland	tmld
truesnow	trsn
watchesonnet	waon
wbshop	wbsh
worldofwatches	wowa
y_3	y3y3
yoox	yoox
yoyo	yoyo
zippo	zipo
shopbop	sbop
joesnewbalanceoutlet	jnbo
watches	waes
rakuten	rktnjp
ebay	ebay
watchmaxx	wmax
sportsshoes	spsh
size	size
zalando	zaldde
certifiedwatchstore	cfws
areatrend	artd
watchstation	wstt
coach	coch
swarovski	swrs
canada_goose	cags
kenzo	kenz
moncler	mncl