AMZN	amazon
AMZNJP	amazon
AMZNDE	amazon
ETBY	eastbay
SXPM	6pm
ZPOS	zappos
FINL	finishline
JMSH	jomashop
JACB	jacobtime
AINC	ashford
BFLY	bluefly
RLLR	ralphlauren
ADDS	adidas
AEAE	ae
ASCL	asos
SAMK	7forallmankind
WACO	watchco
NWEG	newegg
OLSH	onlineshoes
VCTRS	victoriassecret
MSST	misssixty
LEVIS	levi
JCCT	juicycouture
SHBC	shoebacca
DESL	diesel
NDST	nordstrom
EBAG	ebags
TTBX	titleboxing
NBCL	noblecollection
BKCY	backcountry
NMMC	neimanmarcus
BTVT	bottegaveneta
BRBY	burberry
CAMP	campmor
CLARKS	clarksusa
COLM	columbia
DKS	dicks
DRMT	drmartens
ECCO	ecco
EYSV	eyesave
PKYS	pickyourshoes
SHBY	shoebuy
BLDA	bloomingdales
JMJZ	jimmyjazz
MCYS	macys
BYYG	buyeyeglasses
FE21	forever21
FOSL	fossil
HKMK	hockeymonkey
HSPY	hushpuppies
MNTK	minnetonka
NIKE	nike
NIKEHK	nike_hk
NINEW	ninewest
NOKA	nooka
ORLK	orlakiely
OSTK	overstock
SFAN	saksfifthavenue
SKXR	skechers
SHOO	steve madden
SLSH	sunglasshut
THNF	thenorthface
TWCH	thewatchery
TMLD	timberland
TRSN	truesnow
WAON	watchesonnet
WBSH	wbshop
WOWA	worldofwatches
Y3Y3	y_3
YOOX	yoox
YOYO	yoyo
ZIPO	zippo
SBOP	shopbop
JNBO	joesnewbalanceoutlet
WAES	watches
RKTNJP	rakuten
EBAY	ebay
WMAX	watchmaxx
SPSH	sportsshoes
SIZE	size
ZALDDE	zalando
CFWS	certifiedwatchstore
ARTD	areatrend
WSTT	watchstation
COCH	coach
SWRS	swarovski
CAGS	canada_goose
KENZ	kenzo
MNCL	moncler
EZCT	ezcontacts
SSNS	ssence
FFCHCN	farfetch